APControl	KEYWORD1
setSetPoint	KEYWORD2
setProcessOutput	KEYWORD2
setControlAction	KEYWORD2
setMaxControl	KEYWORD2
setMinControl	KEYWORD2
setMaxIncControl	KEYWORD2
setDeltaB	KEYWORD2
setAdaptFact	KEYWORD2
setModel 	KEYWORD2
setTraject	KEYWORD2
setLambda	KEYWORD2
getYd	KEYWORD2
getControlAction	KEYWORD2
getPostErr	KEYWORD2
getProcessOutput	KEYWORD2
getSetPoint	KEYWORD2
getLambda	KEYWORD2
updateVars	KEYWORD2
predictiveAction	KEYWORD2
basicPredictiveAction	KEYWORD2
adaptativeMechanism	KEYWORD2
transferFunction	KEYWORD1
getAm1	KEYWORD2
getAm2	KEYWORD2
getAm3	KEYWORD2
getBm1	KEYWORD2
getBm2	KEYWORD2
getBm3	KEYWORD2
DEBUG_MODE	LITERAL1